00100000
11100S10
10000010
11111110
0001000F
01110001
01000111
01111100
